3333333333333333333333333333333333333333333333333333333333333333
3000000000333333333333333333333333333333333333333333333333333333
3000000000333333333333333333333333333333333333333333333333333333
3000000000333333333333333333333333333333333333333333333333333333
3000000000000000000000000000000000000000000000000000000000003333
3000010000000000000000000000000000000000000000000000000000003333
3000000000000000000000000000000000000000000000000000000000003333
3000000000333333333333333333333333333333333333333333333330003333
3000000000300000000000000000000000000000000000000000000030003333
3000000000300000000000000000000000000000000000000000000030003333
3333000333300000000000000000000000000000000000000000000030003333
3000000000000000000000000000000000000000000000000000000030003333
3000000000000000000000000000000000000000000000000000000030003333
3000000000000000000000000000000000000000000000000000000030003333
3000000000000000000000000000000000000000000000000000000030003333
3000000000000000000000000000000000000000000000000000000030003333
3000000000000000000000000000000000000000000000000000000030003333
3000000000000000000000000000000000000000000000000000000030003333
3000000000000000000000000000000000000000000000000000000030003333
3000000000000000000000000000000000000000000000000000000030003333
3000000000000000000000000000000000000000000000000000000030003333
3000000000000000000000000000000000000000000000000000000030003333
3000000000000000000000000000000000000000000000000000000030003333
3000000000000000000000000000000000000000000000000000000030003333
3000000000000000000000000000000000000000000000000000000030003333
3000000000000000000000000000000000000000000000000000000030003333
3000000000000000000000000000000000000000000000000000000030003333
3000000000000000000000000000000000000000000000000000000030003333
3000000000000000000000000000000000000000000000000000000030003333
3000000000000000000000000000000000000000000000000000000030003333
3000000000000000000000000000000000000000000000000000000030003333
3000000000000000000000000000000000000000000000000000000030003333
3000000000000000000000000000000000000000000000000000000030003333
3000000000000000000000000000000000000000000000000000000030003333
3000000000000000000000000000000000000000000000000000000030003333
3000000000000000000000000000000000000000000000000000000030003333
3000000000000000000000000000000000000000000000000000000030003333
3000000000000000000000000000000000000000000000000000000030003333
3000000000000000000000000000000000000000000000000000000030003333
3000000000000000000000000000000000000000000000000000000030003333
3000000000000000000000000000000000000000000000000000000030003333
3000000000000000000000000000000000000000000000000000000030003333
3000000000000000000000000000000000000000000000000000000030003333
3000000000000000000000000000000000000000000000000000000030003333
3000000000000000000000000000000000000000000000000000000030003333
3000000000000000000000000000000000000000000000000000000030003333
3000000000000000000000000000000000000000000000000000000030003333
3000000000000000000000000000000000000000000000000000000030003333
3000000000000000000000000000000000000000000000000000000030003333
3000000000000000000000000000000000000000000000000000000030003333
3000000000000000000000000000000000000000000000000000000030003333
3000000000000000000000000000000000000000000000000000000030003333
3000000000000000000000000000000000000000000000000000000030003333
3000000000000000000000000000000000000000000000000000033330003333
3000000000000000000000000000000000000000000000000000030000000003
3000000000000000000000000000000000000000000000000000030000000003
3000000000000000000000000000000000000000000000000000030000000003
3000000000000000000000000000000000000000000000000000000000000003
3000000000000000000000000000000000000000000000000000000000200003
3000000000000000000000000000000000000000000000000000000000000003
3000000000000000000000000000000000000000000000000000030000000003
3000000000000000000000000000000000000000000000000000030000000003
3000000000000000000000000000000000000000000000000000030000000003
3333333333333333333333333333333333333333333333333333333333333333 
